0000000000000000000000000000000000000000110000000000000000000000000000000000000000001
0000000000000000000000000000000000000000110000000000000000000000000000000000000000001
0000000000000000000000000000000000000000110000000000000000000000000000000000000000001
0000011111000000000000000000000000000000110000000000000000000000000000000000000000001
0000000000001100000000000000000000000000110000000000000000000000000000000000000000001
0000000000000000110010000000100000000000110000000000000000000000000000000000000000001
0000000000000000000011111111100011000000110000000000000000000000000000000000000000001
0000000000000000000000001111100000000000110000000000000000000000000000000000000000001
0000000000000000000000000011110000000100110001110011001100010000111111111111111111111
0000000000000000000000000000000000000000110000010000000000000000111111111111111111111
0000000000000000000000000000000001100000111000010000000000000011111111111111111111111
0000000000000000011100100000000011110000011100010000000000000000000000000000000000001
0000000000001110001000111100011111111100000000110000000000110000000000000000000000001
1111100111000100001000111100011111111110000000110000000000000010000000000000000000001
1111100010000100001000111100011111111111111111110000000000000001111111111111111111111
1111100010000100001000111100011111111111111111110000000000000001111111111111111111111
1111100010000100001000111100011111111111111111110000000000000001111111111111111111111
1111100010000100001000111100011111111111111111110000000000000001111111111111111111111
1111100010000100001000111100011111111111111111110000000000000001111111111111111111111
1111100010000100001000111100011111111111111111110000000000000001111111111111111111111
1111100010000100001000111100011111111111111111110000000000000001111111111111111111111
1111100010000100001000111100011111111111111111110000000000000001111111111111111111111
