0000000000000000000000000000000000000000000000
0000000000000000000000000000000000000001110000
0000000000000001000000000000000000000011110000
0000000000000011100000000001001000111111110000
0000000001111111111111111000000000000000000000
0000000010000000000000000000000000000000000000
0001100000000000000000000000000000000000000000
0000000000000000000000000000000000000000000000
0000011000000000000000000000000000000000000000
0000000000100000000000000000000000000000000000
0000000000000000000000000000000000000000000000
0000000100000000000000000000000000000000000000
0000001100000000000000000000000000000011110000
1111111100010001110000000000000000000111110000
1100000000000001111000000011000001000000000000
1000000000000001111111100000000000000000000000
0000000000000001111111110000000000000000000000
0000000000000000000000000110000000100000000000
0000000000000000000000000000001001110001100000
00000000000000000000000011110000000000000000010
0000000000000000000001100000000000000000000000
0000000000000000011000000000000000000000011110
0000000000000110000000000000000000000000111110
0000000000100000000000000000000000000001111110
0000000100000100000000011000000110000011111110
0000000000000000000011111100000000001111111100
1111100000000000111111111111000000011111111100
1111100000000000111111111111000000011111111100
1111100000000000111111111111000000011111111100
1111100000000000111111111111000000011111111100