0000000000000000000000000000000000000000110000000000000000000000000000001111111111111
0000000000000000000000000000000000000000110000000000000000000000000000001111111111111
000000a0a0000000000000000000000000000000110000000000000000000000000000001111111111111
0000011111000000000000000000000000000000110000000000000000000000000000001111111111111
0000000000001100000000000000000000000000110000000000000000000000000000001111111111111
0000000000000000110010a000a0100000000000110000000000000000000000000000001111111111111
0000000000000000000011111111100011000000110000000000000000000000000000001111111111111
000000000000000000000000111110000000000011000000000000000000000000a000a01111111111111
0000000000000000000000000011110000000100110001110011001100010000111111111111111111111
0000000000000000000000000000000000000000110000010000000000000000111111111111111111111
0000000000000000000000000000000001100000111000010000000000000011111111111111111111111
000000000000000001110010a00000a011110000011100010000000000000000000000000000000000001
p0000000a0001110001000111100011111111100000000110000000000110000000000000000000000001
11111001110001000010001111000111111111100a00a0110000000000000010000a0000a0000000k0001
1111100010000100001000111100011111111111111111110000000000000001111111111111111111111
1111100010000100001000111100011111111111111111110000000000000001111111111111111111111
1111100010000100001000111100011111111111111111110000000000000001111111111111111111111
1111100010000100001000111100011111111111111111110000000000000001111111111111111111111
1111100010000100001000111100011111111111111111110000000000000001111111111111111111111
1111100010000100001000111100011111111111111111110000000000000001111111111111111111111
1111100010000100001000111100011111111111111111110000000000000001111111111111111111111
1111100010000100001000111100011111111111111111110000000000000001111111111111111111111
