0000000000000000000000000000000000000000000000
0000000000000000000000000000000000000001110000
000000000000000a000000000000000000a0k011110000
00000000000a001110000a000001001000111111110000
0000000001111111111111111000000000000000000000
0000000010000000000000000000000000000000000000
0001100000000000000000000000000000000000000000
0000000000000000000000000000000000000000000000
0000011000000000000000000000000000000000000000
0000000000100000000000000000000000000000000000
0000000000000000000000000000000000000000000000
000000010000000000000000000000000000000a000000
0a00a01110000000000000000000000000000011110000
1111111100010001110000000000000000000111110000
1100000000000001111000000000000000001111110000
1000000000000001111111100011000000000000000000
0000000000000001111111110000000000000000000000
0000000000000000000000000000001000100000000000
00000000000000000000000000a0000001110001100000
0000000000000000000000000111000000000000000001
0000000000000000000001100000000000000000000000
0000000000000000011000000000000000000000011110
0000000000000110000000000000000000000000111110
0000000000100000000000000000000000000001111110
000000010000000000000a011000000110000011111110
p00000000000000000a011111100000000001111111100
1111100000000000111111111111000000011111111100
1111100000000000111111111111000000011111111100
1111100000000000111111111111000000011111111100
1111100000000000111111111111000000011111111100